################################################################################################
################################################################################################
################################################################################################
##############################################.#################################################
##############################################.#################################################
##############################################.#################################################
##############################################.#################################################
##############################################.#################################################
##############################################.#########........################################
##############################################.#########........################################
##############################################.#########........################################
##############################################.#########........################################
##############################################.#########.........###############################
##############################......#######........#####.........###############################
##############################......#######........######........###############################
##############################......#######........######........#........######################
##############################...................................#........######################
##############################......#######........######........#........##########.###########
##############################......#######........######........#........##########.###########
###########################################........######........#........##########.###########
###########################################........#########.#####........##########.###########
###############################################.############.#####........##########.###########
###############################################.############.#####........###.######.###########
###############################################.############.#####........###.######.###########
###############################################.############.#########.######.######.###########
###############################################.############.#########.######.######.###########
###############################################.############.#########.######.######.###########
###############################################.############.#########.######...............####
###############################################.##########......######.######...............####
#############################################.......######......######.######...............####
#############################################.......######......######.######...............####
#############################################.......######..................................####
#############################################...................######.######...............####
#############################################.......######......######.######...............####
#############################################...*...######......######.######...............####
#############################################.......######......######.######.######.###########
############################################################.#########.######.######.###########
############################################################.#########.######.######.###########
############################################################.#########.######.######.###########
########################################################...........................#.###########
##########################################################....................######.###########
############################################################.######......###########.###########
############################################################.######......###########.###########
############################################################.######......###########.###########
########################################################........###......###########.###########
########################################################........###......###########.###########
########################################################........###......#######################
########################################################........###......#######################
########################################################........######.#########################
########################################################........######.#########################
######################################################################.#########################
######################################################################.#########################
################################################################################################
################################################################################################
################################################################################################
################################################################################################
################################################################################################
################################################################################################
################################################################################################
################################################################################################
################################################################################################
################################################################################################
################################################################################################
################################################################################################
