################################################################################################
################################################################################################
################################################################################################
###################################.############################################################
###################################.############################################################
###################################.############################################################
###################################.############################################################
###################################.############################################################
###################################.############################################################
###################################.############################################################
###################################.############################################################
###################################.############################################################
###################################.############################################################
#################################......#########################################################
#######################.#########......#########################################################
#######################.#########......#########################################################
##################...................................###########################################
#######################.#########......#########################################################
#######################.#########......####.####################################################
#######################.#########......####.####################################################
#######################.#########......####.####################################################
#######################.############.######.####################################################
#######################.############.######.####################################################
#######################.############.######.####################################################
#######################.############.######.####################################################
#######################.############.###......##################################################
#######################.############.###......##################################################
#######################.############.###......##################################################
#######################.############.###......##################################################
####################........########.##.............############################################
####################........########.##.............############################################
#####.......................########.##.............############################################
####################..*.................................########################################
####################........########.##.............###.########################################
####################........###...........................######################################
#######################.############.######.#.......###.########################################
#######################.############.######.#.####.####.########################################
######################..############.######.#.####.####.########################################
######################..############.######.#.####.####.########################################
######################..############.######.#.####.####.########################################
######################..############.######.#.####.####.########################################
######################..#####.######.######.#.####.####.########################################
######################..#####.######.######......#.####.########################################
###############.........#####.######.######......#.####.########################################
###############.........#####.######.######......#.####.########################################
###############.........#####.######.######..............#######################################
########..............................................................##########################
###############........######.##........###......#.####.########################################
###############........######.##........###......#.####.########################################
######################.#...........................####.########################################
######################.#......##........###........####.########################################
######################.#......##........###........####.########################################
######################.#......##........###........####.########################################
#################.........................................######################################
######################.#......######.###...........####.########################################
######################.#......######.###...........####.########################################
########################......######.###...........####.########################################
####################################.###......####.####.########################################
####################################.###......####.####.########################################
####################################.###......####.#############################################
####################################.###......####.#############################################
####################################.###########################################################
################################################################################################
################################################################################################
