################################################################################
################################################################################
################################################################################
################################################################################
################################################################################
################################################################################
################################################################################
################################################################################
################################################################################
################################################################################
################################################################################
################################################################################
################################################################################
################################################################################
################################################################################
################################################################################
################################################################################
################################################################################
################################################################################
################################################################################
################################################################################
################################################################################
################################################################################
################################################################################
################################################################################
################################################.###############################
################################################.###############################
#####################################.......####.###############################
#####################################.......####.###############################
#####################################.......####.###############################
#####################################.......####.###############################
#####################################.......####.###############################
#####################################.......####..##############################
#####################################.......####..##############################
#######################################.########..##############################
#######################################.########..##############################
###############################.#######.########..##############################
#########################.#####.#######.#######...##############################
#########################.#####.#######.#######...##############################
#########################.#.###.#######.#######...##############################
#########################.#.###.#######.######......############################
################........#.#.###.#######.######........##########################
################........#.#.##..#######.######........##########################
################........#.#.##..#######.######.................#################
################......................................##########################
################........#.#.##..#######.######........##########################
################........#.#.##..#######.######........##########################
#######################.........#######.######.........#########################
##################..............#######.#######..........#######################
##################..............#######.#######..........#######################
##################..............#######.#######..........#######################
#############.....................................................##############
##################................#####.#######..........#######################
##################................#####.#######..........#######################
#######################...........#####.#######........#########################
#########################.#.......#####.#########.##############################
#########################.#.......#####.########################################
#########################.#.##..#######.########################################
#########################.#.##..#######.########################################
################################################################################
